##########
####p   ##
##  cc   #
##    ####
##.. #####
##########
